{
  "playing_area_width": 615,
  "blocks": [
    "....................",
    "....................",
    "....................",
    ".......222222.......",
    ".......2TTTT2.......",
    ".......222222.......",
    "....................",
    "....................",
    "....................",
    "....................",
    "....................",
    "....................",
    "....................",
    "....................",
    "....222222222222...."
  ]
}
