{
  "playing_area_width": 615,
  "blocks": [
    "....................",
    "....................",
    "....................",
    ".......222222.......",
    ".......211112.......",
    ".......222222......"
  ]
}
